R 1000 1000
NO textures/wall_1.xpm
SO textures/wall_6.xpm
WE textures/wall_3.xpm
EA textures/wall_4.xpm
S textures/sprite_1.xpm
F 128,128,128
C 60,102,222

        1111111111111111111111111
        1000000000110000000000001
        1011000001110000002000001
        1001000000000000000000001
111111111011000001110000000000001
100000000011000001110001111111111
11110111111111011100000010001
11110111111111011101010000001
11000000110101011100000000W01
10002000000000001100020000001
10000000000000001101010010001
1100000111010101111101111000111
11110111 1110101 101111010001
11111111 1111111 111111111111

